#
# 0 D room1.txt 1 key1
# 1 D room1.txt 0
#
# k key1
#
WWWWWWWWWW
W S  G   W
W t      W
W  m  kt W
W  t  t  W
W t    W W
W    B WhW
Wt  WWWW W
0   W    W
WWWWW1WWWW